h, 2, 2, 0
h, 3, 0, 2
v, 2, 1, 2
v, 3, 1, 3
h, 2, 3, 4
h, 3, 4, 1
v, 2, 4, 5
h, 3, 5, 0
h, 2, 5, 3
