h, 2, 2, 1
h, 3, 0, 1
v, 3, 0, 5
v, 3, 1, 0
v, 3, 1, 3
v, 3, 1, 4
v, 2, 4, 2
h, 2, 4, 3
h, 3, 5, 3
