h, 2, 2, 0
h, 3, 0, 0
v, 3, 0, 3
v, 3, 0, 4
v, 2, 1, 5
v, 2, 3, 2
v, 2, 4, 0
h, 3, 4, 3
h, 2, 5, 4
