h, 2, 2, 0
v, 2, 0, 0
v, 3, 0, 4
v, 3, 0, 5
h, 3, 1, 1
v, 2, 2, 3
v, 2, 3, 1
v, 2, 4, 0
h, 3, 4, 2
