h, 2, 2, 0
h, 3, 0, 3
h, 3, 1, 1
v, 3, 1, 4
v, 2, 1, 5
v, 3, 2, 3
h, 2, 3, 0
v, 2, 4, 2
h, 2, 4, 4
h, 2, 5, 4
