h, 2, 2, 0
v, 3, 0, 3
v, 3, 0, 4
v, 3, 2, 5
h, 3, 3, 0
v, 2, 4, 2
h, 3, 5, 3
