h, 2, 2, 0
h, 3, 0, 3
h, 2, 1, 0
v, 3, 1, 4
v, 3, 3, 1
h, 2, 3, 2
v, 2, 4, 2
h, 2, 4, 4
