h, 2, 2, 0
h, 2, 0, 2
v, 3, 0, 4
h, 2, 1, 1
v, 3, 1, 3
v, 3, 1, 5
h, 3, 3, 0
v, 2, 4, 0
h, 3, 4, 3
h, 3, 5, 2
