h, 2, 2, 0
v, 2, 0, 3
v, 3, 0, 5
v, 2, 1, 2
v, 3, 1, 4
v, 2, 2, 3
h, 2, 3, 0
v, 2, 4, 0
h, 3, 4, 3
h, 2, 5, 1
