h, 2, 2, 0
v, 3, 0, 3
v, 3, 0, 4
h, 2, 1, 0
v, 2, 3, 0
h, 2, 3, 4
v, 2, 4, 2
h, 3, 5, 3
