h, 2, 2, 0
v, 2, 0, 0
v, 2, 0, 3
v, 3, 0, 4
v, 3, 0, 5
v, 3, 3, 1
h, 2, 3, 3
v, 2, 4, 0
v, 2, 4, 2
h, 3, 5, 3
