h, 2, 2, 2
v, 3, 0, 1
h, 2, 0, 3
v, 2, 1, 0
v, 3, 1, 4
v, 3, 1, 5
h, 2, 3, 0
v, 2, 3, 2
h, 3, 4, 3
h, 3, 5, 1
