h, 2, 2, 0
h, 3, 0, 0
h, 3, 0, 3
h, 3, 1, 2
v, 3, 1, 5
v, 3, 2, 2
v, 2, 2, 4
h, 2, 4, 3
h, 3, 5, 1
