h, 2, 2, 2
h, 3, 0, 0
h, 2, 0, 3
v, 3, 0, 5
h, 2, 1, 2
v, 2, 1, 4
v, 2, 3, 1
h, 3, 3, 2
v, 2, 4, 3
h, 2, 4, 4
