h, 2, 2, 1
v, 3, 0, 0
v, 3, 0, 3
v, 2, 2, 5
h, 2, 3, 1
v, 2, 3, 4
v, 2, 4, 1
h, 2, 4, 2
h, 3, 5, 2
