h, 2, 2, 0
v, 3, 0, 2
v, 3, 0, 5
v, 2, 1, 4
h, 3, 3, 2
h, 3, 4, 2
h, 2, 5, 0
