h, 2, 2, 1
v, 2, 0, 0
h, 3, 0, 3
h, 2, 1, 1
v, 3, 1, 4
v, 3, 2, 5
h, 3, 3, 0
v, 2, 4, 2
h, 2, 4, 3
