h, 2, 2, 2
h, 3, 0, 1
v, 3, 1, 0
v, 3, 1, 4
v, 2, 2, 5
v, 3, 3, 1
v, 2, 4, 2
h, 3, 4, 3
