h, 2, 2, 2
v, 2, 0, 1
v, 3, 0, 4
v, 3, 1, 0
v, 2, 1, 5
v, 2, 2, 1
v, 2, 3, 2
h, 2, 4, 3
v, 2, 4, 5
h, 2, 5, 3
