h, 2, 2, 0
h, 3, 0, 2
v, 3, 0, 5
v, 3, 1, 4
v, 2, 2, 2
v, 2, 4, 2
h, 2, 4, 4
