h, 2, 2, 0
v, 2, 0, 1
v, 2, 0, 4
v, 3, 1, 2
v, 2, 1, 5
h, 2, 3, 0
h, 2, 3, 4
h, 3, 4, 2
v, 2, 4, 5
h, 3, 5, 0
