h, 2, 2, 3
v, 3, 0, 0
v, 3, 0, 5
h, 3, 1, 2
h, 2, 3, 1
v, 2, 4, 2
v, 2, 4, 3
h, 2, 4, 4
