h, 2, 2, 0
v, 3, 0, 2
h, 2, 0, 3
v, 3, 0, 5
v, 2, 3, 0
h, 3, 4, 2
h, 3, 5, 1
