h, 2, 2, 2
v, 3, 0, 1
h, 3, 0, 2
h, 3, 1, 2
v, 3, 1, 5
v, 3, 2, 0
v, 2, 2, 4
v, 2, 3, 3
h, 2, 4, 4
h, 3, 5, 1
