h, 2, 2, 3
v, 3, 0, 0
h, 3, 0, 2
v, 3, 0, 5
h, 3, 1, 2
v, 2, 2, 2
v, 2, 3, 1
v, 3, 3, 3
v, 2, 4, 2
h, 2, 5, 4
