h, 2, 2, 0
v, 3, 0, 2
v, 3, 2, 3
v, 3, 3, 0
h, 2, 3, 1
v, 2, 3, 4
h, 2, 4, 1
v, 2, 4, 5
