h, 2, 2, 2
v, 3, 0, 1
v, 3, 0, 5
v, 3, 1, 0
h, 2, 1, 3
v, 3, 3, 2
h, 2, 3, 4
v, 2, 4, 0
v, 2, 4, 3
h, 2, 4, 4
