h, 2, 2, 0
v, 3, 0, 2
v, 3, 0, 5
v, 2, 1, 3
h, 3, 3, 1
h, 2, 4, 3
h, 2, 5, 1
