h, 2, 2, 0
v, 2, 0, 0
v, 3, 0, 2
h, 2, 1, 3
v, 3, 1, 5
h, 3, 3, 2
h, 3, 4, 0
