h, 2, 2, 1
h, 2, 0, 0
v, 2, 0, 5
v, 3, 1, 3
v, 3, 2, 0
v, 2, 3, 2
h, 3, 4, 3
h, 3, 5, 0
