h, 2, 2, 3
h, 2, 0, 2
v, 3, 0, 5
v, 2, 1, 2
v, 3, 2, 0
v, 3, 3, 3
h, 2, 3, 4
h, 2, 4, 1
h, 2, 5, 0
