h, 2, 2, 1
v, 3, 0, 4
v, 3, 0, 5
v, 3, 3, 2
v, 3, 3, 3
h, 2, 3, 4
h, 2, 4, 4
