h, 2, 2, 0
h, 2, 0, 0
h, 2, 0, 2
h, 3, 1, 0
v, 3, 1, 4
v, 2, 2, 3
v, 2, 3, 0
v, 2, 4, 2
h, 3, 4, 3
h, 2, 5, 4
