h, 2, 2, 0
h, 3, 0, 2
v, 2, 1, 4
v, 2, 2, 2
h, 3, 3, 3
v, 2, 4, 2
h, 2, 4, 4
