h, 2, 2, 2
h, 2, 0, 2
v, 3, 0, 4
v, 3, 0, 5
h, 3, 1, 1
v, 2, 2, 1
v, 3, 3, 0
v, 2, 3, 3
h, 2, 4, 4
h, 3, 5, 1
