h, 2, 2, 0
h, 3, 0, 0
v, 3, 0, 4
h, 2, 1, 2
v, 3, 3, 0
v, 2, 3, 1
h, 3, 3, 2
h, 3, 4, 3
h, 2, 5, 2
h, 2, 5, 4
