h, 2, 2, 0
v, 2, 0, 1
h, 3, 0, 2
v, 3, 0, 5
v, 3, 1, 4
v, 3, 3, 0
h, 3, 3, 1
h, 2, 4, 2
h, 2, 4, 4
h, 3, 5, 3
