h, 2, 2, 2
h, 3, 0, 2
v, 2, 1, 0
v, 3, 1, 4
v, 3, 2, 5
h, 3, 3, 0
v, 2, 4, 0
v, 2, 4, 1
h, 3, 4, 2
h, 3, 5, 2
