h, 2, 2, 0
h, 2, 0, 3
v, 3, 0, 5
h, 3, 1, 0
v, 2, 2, 2
v, 2, 2, 4
v, 2, 3, 0
h, 2, 4, 1
h, 2, 4, 4
h, 3, 5, 1
