h, 2, 2, 0
v, 3, 0, 2
h, 3, 1, 3
v, 2, 2, 3
v, 3, 3, 1
h, 3, 4, 2
v, 2, 4, 5
h, 2, 5, 2
