h, 2, 2, 0
v, 2, 0, 0
v, 2, 0, 1
v, 3, 0, 2
v, 3, 1, 5
v, 2, 2, 4
h, 3, 3, 0
h, 2, 4, 0
v, 2, 4, 3
h, 2, 5, 1
