h, 2, 2, 2
v, 3, 0, 4
v, 2, 0, 5
v, 3, 3, 2
h, 2, 3, 3
v, 3, 3, 5
v, 2, 4, 0
