h, 2, 2, 1
v, 3, 0, 0
h, 2, 0, 1
v, 3, 0, 3
v, 3, 1, 4
v, 2, 3, 0
v, 2, 4, 1
h, 2, 4, 2
h, 3, 5, 3
