h, 2, 2, 0
v, 2, 0, 0
v, 3, 0, 2
h, 3, 0, 3
h, 2, 3, 0
v, 2, 3, 5
h, 3, 4, 0
v, 2, 4, 3
v, 2, 4, 4
h, 2, 5, 1
