h, 2, 2, 1
h, 3, 0, 0
v, 3, 0, 4
v, 3, 0, 5
v, 2, 1, 3
v, 3, 2, 0
h, 3, 3, 3
v, 2, 4, 2
h, 2, 5, 4
