h, 2, 2, 1
v, 2, 0, 2
v, 3, 0, 3
v, 3, 0, 4
v, 3, 1, 0
v, 2, 2, 5
h, 3, 3, 2
h, 3, 4, 3
h, 3, 5, 1
