h, 2, 2, 0
h, 2, 0, 1
h, 2, 0, 3
h, 2, 1, 1
v, 3, 1, 5
h, 2, 3, 0
h, 3, 3, 2
v, 2, 4, 0
h, 2, 5, 1
h, 3, 5, 3
