h, 2, 2, 1
h, 3, 0, 1
v, 3, 0, 5
v, 3, 2, 3
v, 3, 3, 2
v, 2, 4, 1
h, 2, 4, 4
