h, 2, 2, 2
v, 2, 0, 0
v, 2, 0, 3
v, 3, 0, 4
v, 2, 1, 1
v, 3, 1, 5
h, 3, 3, 0
v, 2, 4, 2
h, 2, 4, 4
