h, 2, 2, 0
v, 3, 0, 4
v, 2, 2, 5
v, 3, 3, 1
h, 3, 3, 2
v, 2, 4, 2
h, 3, 5, 3
