h, 2, 2, 2
v, 3, 0, 5
h, 2, 1, 2
v, 3, 2, 4
v, 2, 3, 1
v, 3, 3, 2
v, 3, 3, 3
h, 2, 5, 4
