h, 2, 2, 1
h, 3, 0, 1
v, 3, 0, 4
v, 3, 1, 0
h, 3, 1, 1
v, 2, 3, 2
v, 2, 3, 3
h, 2, 3, 4
v, 2, 4, 5
h, 3, 5, 0
