h, 2, 2, 1
v, 2, 0, 2
h, 3, 0, 3
v, 2, 1, 4
v, 3, 2, 5
h, 2, 3, 0
h, 3, 3, 2
h, 3, 4, 1
h, 3, 5, 1
