h, 2, 2, 1
v, 2, 0, 1
v, 3, 0, 4
v, 3, 0, 5
h, 2, 1, 2
v, 2, 2, 3
v, 2, 4, 2
h, 2, 4, 4
h, 3, 5, 3
