h, 2, 2, 0
h, 3, 0, 1
v, 2, 1, 4
v, 3, 2, 3
v, 3, 2, 5
h, 3, 3, 0
v, 2, 4, 2
h, 2, 5, 4
