h, 2, 2, 1
v, 3, 0, 0
h, 3, 0, 2
v, 3, 1, 4
v, 3, 2, 3
v, 2, 3, 1
h, 2, 4, 4
