h, 2, 2, 0
v, 3, 0, 3
v, 3, 0, 4
v, 3, 0, 5
v, 2, 2, 2
h, 2, 3, 0
h, 2, 4, 3
h, 3, 5, 1
