h, 2, 2, 2
v, 2, 0, 2
v, 3, 0, 5
v, 2, 1, 1
h, 2, 1, 3
v, 2, 2, 4
v, 2, 3, 2
v, 2, 3, 3
h, 2, 4, 4
h, 3, 5, 1
