h, 2, 2, 0
h, 3, 0, 1
v, 3, 0, 4
v, 2, 1, 2
v, 3, 1, 3
v, 2, 1, 5
v, 2, 4, 2
h, 2, 5, 4
